6 8 4
011110
112210
153210
113211
112321
143221
144241
111111
