8 7 4
00111110
11122510
12234211
12243421
11126321
00122211
00111110
