10 8 7
0111111100
0144442100
1114443111
1223132321
1233221321
1222212221
1111252111
0001111100
