9 9 6
111111110
122222210
121332210
124441210
114443211
012112321
013223221
012212251
011111111
