11 10 6
00000111111
01111142221
01221441121
01223442221
01221241211
11121131221
12322223321
12131221221
15221111111
11111000000
