11 10 6
11111111111
12222122221
12353333321
12222222221
11111211111
00014221000
00014221000
00014441000
00014221000
00011111000
