10 6 5
1111111111
1122222221
1222131321
1233224341
1251114441
1111111111
