11 9 6
01111111110
01221122210
01222322210
01321112310
01216641210
11216441211
12222222221
12522212221
11111111111
